##########
#        #
# $##$   #
#  .     #
# $#$    #
#  .     #
# $  $   #
#. . .   #
#   @    #
##########
