##########
#        #
#  ##$ . #
#  .     #
# $#$    #
#  .     #
# $  $   #
#   .  . #
#   @    #
##########
