##########
#     #  #
# $#$# $ #
#  . .   #
# # # #  #
#  $#$   #
# $ . $  #
# #$@$.  #
#   .    #
##########
