##########
#  #     #
# $  $ $ #
# #.#.#  #
# $ $ $  #
#  .@.   #
# # $ #  #
# #.#.#  #
#   .    #
##########
