##########
#  #    .#
# $  $ $ #
# #.#.#  #
# $ $ $  #
#   @  . #
# #  $ # #
# #.#.#  #
#   .    #
##########