##########
#  #     #
# $#  $  #
#  .#.   #
#  #.#   #
# $#$  $ #
#  .  .  #
#  $@ $  #
# .  .   #
##########
