##########
#  #     #
# $#$ $  #
#  .#.   #
#  #.#   #
# $#$    #
#  . .   #
# $$@$$  #
#  . .   #
##########
