##########
#        #
# $  $   #
#        #
#. .     #
#        #
# $  $   #
#. .     #
#   @    #
##########
