##########
#    #####
# $  $   #
#        #
#.     . #
#        #
# $    $ #
#.  .@   #
#####    #
##########
