##########
#    .#. #
# $#$# $ #
#  .  .  #
# # # #  #
#  $#    #
# $ . $  #
# # @$.  #
#  .     #
##########
